{
    "build": [
        "000072@海虹1栋",
        "000073@海虹2栋",
        "000074@海虹3栋",
        "000075@海虹4栋",
        "000076@海虹5栋",
        "000083@余区1舍（原老1栋）",
        "000084@余区2舍（原老2栋）",
        "000085@余区3舍（拆除）",
        "000086@余区4舍（拆除）",
        "000087@余区5舍（拆除）",
        "000088@余区6舍（拆除）",
        "000089@余区7舍（原海虹6栋）",
        "000090@余区8舍（原海虹7栋）",
        "000091@余区9舍（原研究生1栋）",
        "000077@余区10舍（原研究生2栋）",
        "000078@余区11舍（原研究生3栋）",
        "000079@余区12舍（原研究生4栋）",
        "000080@余区13舍（原研究生5栋）",
        "000081@余区14A舍（原老7栋）",
        "000082@余区14B舍（原老8栋）",
        "000092@余区15舍"
    ],
    "4": {
        "buildid": "000075",
        "floor": [
            1,
            2,
            3,
            4,
            5,
            6,
            7
        ]
    },
    "5": {
        "buildid": "000076",
        "floor": [
            1,
            2,
            3,
            4,
            5,
            6,
            7
        ],
        "roomlist": [
            "00011533@海虹5栋-101",
            "00011534@海虹5栋-102",
            "00011535@海虹5栋-103",
            "00011536@海虹5栋-104",
            "00011537@海虹5栋-105",
            "00011538@海虹5栋-106",
            "00011539@海虹5栋-107",
            "00011540@海虹5栋-108",
            "00011541@海虹5栋-109",
            "00011542@海虹5栋-110",
            "00011543@海虹5栋-111",
            "00011544@海虹5栋-112",
            "00011545@海虹5栋-113",
            "00011546@海虹5栋-114",
            "00011547@海虹5栋-115",
            "00011548@海虹5栋-116",
            "00011549@海虹5栋-117",
            "00011550@海虹5栋-118",
            "00011551@海虹5栋-119",
            "00011552@海虹5栋-120",
            "00011553@海虹5栋-121",
            "00011554@海虹5栋-122",
            "00011555@海虹5栋-123",
            "00011556@海虹5栋-124",
            "00011557@海虹5栋-125",
            "00011558@海虹5栋-126",
            "00011559@海虹5栋-127",
            "00011560@海虹5栋-128",
            "00011561@海虹5栋-129",
            "00011562@海虹5栋-130",
            "00011563@海虹5栋-131",
            "00011564@海虹5栋-132",
            "00011565@海虹5栋-133",
            "00011566@海虹5栋-134",
            "00011567@海虹5栋-135",
            "00011568@海虹5栋-136",
            "00011569@海虹5栋-137",
            "00011570@海虹5栋-138",
            "00011571@海虹5栋-139",
            "00011572@海虹5栋-140",
            "00011573@海虹5栋-141",
            "00011574@海虹5栋-142",
            "00011575@海虹5栋-143",
            "00011576@海虹5栋-144",
            "00011577@海虹5栋-145",
            "00011578@海虹5栋-146",
            "00011579@海虹5栋-147",
            "00011580@海虹5栋-148",
            "00011581@海虹5栋-149",
            "00011582@海虹5栋-150",
            "00011583@海虹5栋-201",
            "00011584@海虹5栋-202",
            "00011585@海虹5栋-203",
            "00011586@海虹5栋-204",
            "00011587@海虹5栋-205",
            "00011588@海虹5栋-206",
            "00011589@海虹5栋-207",
            "00011590@海虹5栋-208",
            "00011591@海虹5栋-209",
            "00011592@海虹5栋-210",
            "00011593@海虹5栋-211",
            "00011594@海虹5栋-212",
            "00011595@海虹5栋-213",
            "00011596@海虹5栋-214",
            "00011597@海虹5栋-215",
            "00011598@海虹5栋-216",
            "00011599@海虹5栋-217",
            "00011600@海虹5栋-218",
            "00011601@海虹5栋-219",
            "00011602@海虹5栋-220",
            "00011603@海虹5栋-221",
            "00011604@海虹5栋-222",
            "00011605@海虹5栋-223",
            "00011606@海虹5栋-224",
            "00011607@海虹5栋-225",
            "00011608@海虹5栋-226",
            "00011609@海虹5栋-227",
            "00011610@海虹5栋-228",
            "00011611@海虹5栋-229",
            "00011612@海虹5栋-230",
            "00011613@海虹5栋-231",
            "00011614@海虹5栋-232",
            "00011615@海虹5栋-233",
            "00011616@海虹5栋-234",
            "00011617@海虹5栋-235",
            "00011618@海虹5栋-236",
            "00011619@海虹5栋-237",
            "00011620@海虹5栋-238",
            "00011621@海虹5栋-239",
            "00011622@海虹5栋-240",
            "00011623@海虹5栋-241",
            "00011624@海虹5栋-242",
            "00011625@海虹5栋-243",
            "00011626@海虹5栋-244",
            "00011627@海虹5栋-245",
            "00011628@海虹5栋-246",
            "00011629@海虹5栋-247",
            "00011630@海虹5栋-248",
            "00011631@海虹5栋-249",
            "00011632@海虹5栋-250",
            "00011633@海虹5栋-301",
            "00011634@海虹5栋-302",
            "00011635@海虹5栋-303",
            "00011636@海虹5栋-304",
            "00011637@海虹5栋-305",
            "00011638@海虹5栋-306",
            "00011639@海虹5栋-307",
            "00011640@海虹5栋-308",
            "00011641@海虹5栋-309",
            "00011642@海虹5栋-310",
            "00011643@海虹5栋-311",
            "00011644@海虹5栋-312",
            "00011645@海虹5栋-313",
            "00011646@海虹5栋-314",
            "00011647@海虹5栋-315",
            "00011648@海虹5栋-316",
            "00011649@海虹5栋-317",
            "00011650@海虹5栋-318",
            "00011651@海虹5栋-319",
            "00011652@海虹5栋-320",
            "00011653@海虹5栋-321",
            "00011654@海虹5栋-322",
            "00011655@海虹5栋-323",
            "00011656@海虹5栋-324",
            "00011657@海虹5栋-325",
            "00011658@海虹5栋-326",
            "00011659@海虹5栋-327",
            "00011660@海虹5栋-328",
            "00011661@海虹5栋-329",
            "00011662@海虹5栋-330",
            "00011663@海虹5栋-331",
            "00011664@海虹5栋-332",
            "00011665@海虹5栋-333",
            "00011666@海虹5栋-334",
            "00011667@海虹5栋-335",
            "00011668@海虹5栋-336",
            "00011669@海虹5栋-337",
            "00011670@海虹5栋-338",
            "00011671@海虹5栋-339",
            "00011672@海虹5栋-340",
            "00011673@海虹5栋-341",
            "00011674@海虹5栋-342",
            "00011675@海虹5栋-343",
            "00011676@海虹5栋-344",
            "00011677@海虹5栋-345",
            "00011678@海虹5栋-346",
            "00011679@海虹5栋-347",
            "00011680@海虹5栋-348",
            "00011681@海虹5栋-349",
            "00011682@海虹5栋-350",
            "00011683@海虹5栋-401",
            "00011684@海虹5栋-402",
            "00011685@海虹5栋-403",
            "00011686@海虹5栋-404",
            "00011687@海虹5栋-405",
            "00011688@海虹5栋-406",
            "00011689@海虹5栋-407",
            "00011690@海虹5栋-408",
            "00011691@海虹5栋-409",
            "00011692@海虹5栋-410",
            "00011693@海虹5栋-411",
            "00011694@海虹5栋-412",
            "00011695@海虹5栋-413",
            "00011696@海虹5栋-414",
            "00011697@海虹5栋-415",
            "00011698@海虹5栋-416",
            "00011699@海虹5栋-417",
            "00011700@海虹5栋-418",
            "00011701@海虹5栋-419",
            "00011702@海虹5栋-420",
            "00011703@海虹5栋-421",
            "00011704@海虹5栋-422",
            "00011705@海虹5栋-423",
            "00011706@海虹5栋-424",
            "00011707@海虹5栋-425",
            "00011708@海虹5栋-426",
            "00011709@海虹5栋-427",
            "00011710@海虹5栋-428",
            "00011711@海虹5栋-429",
            "00011712@海虹5栋-430",
            "00011713@海虹5栋-431",
            "00011714@海虹5栋-432",
            "00011715@海虹5栋-433",
            "00011716@海虹5栋-434",
            "00011717@海虹5栋-435",
            "00011718@海虹5栋-436",
            "00011719@海虹5栋-437",
            "00011720@海虹5栋-438",
            "00011721@海虹5栋-439",
            "00011722@海虹5栋-440",
            "00011723@海虹5栋-441",
            "00011724@海虹5栋-442",
            "00011725@海虹5栋-443",
            "00011726@海虹5栋-444",
            "00011727@海虹5栋-445",
            "00011728@海虹5栋-446",
            "00011729@海虹5栋-447",
            "00011730@海虹5栋-448",
            "00011731@海虹5栋-449",
            "00011732@海虹5栋-450",
            "00011733@海虹5栋-501",
            "00011734@海虹5栋-502",
            "00011735@海虹5栋-503",
            "00011736@海虹5栋-504",
            "00011737@海虹5栋-505",
            "00011738@海虹5栋-506",
            "00011739@海虹5栋-507",
            "00011740@海虹5栋-508",
            "00011741@海虹5栋-509",
            "00011742@海虹5栋-510",
            "00011743@海虹5栋-511",
            "00011744@海虹5栋-512",
            "00011745@海虹5栋-513",
            "00011746@海虹5栋-514",
            "00011747@海虹5栋-515",
            "00011748@海虹5栋-516",
            "00011749@海虹5栋-517",
            "00011750@海虹5栋-518",
            "00011751@海虹5栋-519",
            "00011752@海虹5栋-520",
            "00011753@海虹5栋-521",
            "00011754@海虹5栋-522",
            "00011755@海虹5栋-523",
            "00011756@海虹5栋-524",
            "00011757@海虹5栋-525",
            "00011758@海虹5栋-526",
            "00011759@海虹5栋-527",
            "00011760@海虹5栋-528",
            "00011761@海虹5栋-529",
            "00011762@海虹5栋-530",
            "00011763@海虹5栋-531",
            "00011764@海虹5栋-532",
            "00011765@海虹5栋-533",
            "00011766@海虹5栋-534",
            "00011767@海虹5栋-535",
            "00011768@海虹5栋-536",
            "00011769@海虹5栋-537",
            "00011770@海虹5栋-538",
            "00011771@海虹5栋-539",
            "00011772@海虹5栋-540",
            "00011773@海虹5栋-541",
            "00011774@海虹5栋-542",
            "00011775@海虹5栋-543",
            "00011776@海虹5栋-544",
            "00011777@海虹5栋-545",
            "00011778@海虹5栋-546",
            "00011779@海虹5栋-547",
            "00011780@海虹5栋-548",
            "00011781@海虹5栋-549",
            "00011782@海虹5栋-550",
            "00011783@海虹5栋-601",
            "00011784@海虹5栋-602",
            "00011785@海虹5栋-603",
            "00011786@海虹5栋-604",
            "00011787@海虹5栋-605",
            "00011788@海虹5栋-606",
            "00011789@海虹5栋-607",
            "00011790@海虹5栋-608",
            "00011791@海虹5栋-609",
            "00011792@海虹5栋-610",
            "00011793@海虹5栋-611",
            "00011794@海虹5栋-612",
            "00011795@海虹5栋-613",
            "00011796@海虹5栋-614",
            "00011797@海虹5栋-615",
            "00011798@海虹5栋-616",
            "00011799@海虹5栋-617",
            "00011800@海虹5栋-618",
            "00011801@海虹5栋-619",
            "00011802@海虹5栋-620",
            "00011803@海虹5栋-621",
            "00011804@海虹5栋-622",
            "00011805@海虹5栋-623",
            "00011806@海虹5栋-624",
            "00011807@海虹5栋-625",
            "00011808@海虹5栋-626",
            "00011809@海虹5栋-627",
            "00011810@海虹5栋-628",
            "00011811@海虹5栋-629",
            "00011812@海虹5栋-630",
            "00011813@海虹5栋-631",
            "00011814@海虹5栋-632",
            "00011815@海虹5栋-633",
            "00011816@海虹5栋-634",
            "00011817@海虹5栋-635",
            "00011818@海虹5栋-636",
            "00011819@海虹5栋-637",
            "00011820@海虹5栋-638",
            "00011821@海虹5栋-639",
            "00011822@海虹5栋-640",
            "00011823@海虹5栋-641",
            "00011824@海虹5栋-642",
            "00011825@海虹5栋-643",
            "00011826@海虹5栋-644",
            "00011827@海虹5栋-645",
            "00011828@海虹5栋-646",
            "00011829@海虹5栋-647",
            "00011830@海虹5栋-648",
            "00011831@海虹5栋-649",
            "00011832@海虹5栋-650",
            "00011833@海虹5栋-701",
            "00011834@海虹5栋-702",
            "00011835@海虹5栋-703",
            "00011836@海虹5栋-704",
            "00011837@海虹5栋-705",
            "00011838@海虹5栋-706",
            "00011839@海虹5栋-707",
            "00011840@海虹5栋-708",
            "00011841@海虹5栋-709",
            "00011842@海虹5栋-710",
            "00011843@海虹5栋-711",
            "00011844@海虹5栋-712",
            "00011845@海虹5栋-713",
            "00011846@海虹5栋-714",
            "00011847@海虹5栋-715",
            "00011848@海虹5栋-716",
            "00011849@海虹5栋-717",
            "00011850@海虹5栋-718",
            "00011851@海虹5栋-719",
            "00011852@海虹5栋-720",
            "00011853@海虹5栋-721",
            "00011854@海虹5栋-722",
            "00011855@海虹5栋-723",
            "00011856@海虹5栋-724",
            "00011857@海虹5栋-725",
            "00011858@海虹5栋-726",
            "00011859@海虹5栋-727",
            "00011860@海虹5栋-728",
            "00011861@海虹5栋-729",
            "00011862@海虹5栋-730",
            "00011863@海虹5栋-731",
            "00011864@海虹5栋-732",
            "00011865@海虹5栋-733",
            "00011866@海虹5栋-734",
            "00011867@海虹5栋-735",
            "00011868@海虹5栋-736",
            "00011869@海虹5栋-737",
            "00011870@海虹5栋-738",
            "00011871@海虹5栋-739",
            "00011872@海虹5栋-740",
            "00011873@海虹5栋-741",
            "00011874@海虹5栋-742",
            "00011875@海虹5栋-743",
            "00011876@海虹5栋-744",
            "00011877@海虹5栋-745",
            "00011878@海虹5栋-746",
            "00011879@海虹5栋-747",
            "00011880@海虹5栋-748",
            "00011881@海虹5栋-749",
            "00011882@海虹5栋-750"
        ]
    }
}